Import source files	Importa files primari	
User's	del usuario	
will use	projecto	
(LGPL License)	(Licentia LGPL)	
a number of	plure	
abbreviated	abbreviate	
access	acceder	
accessing	accesso	
aching	dolente	
Acknowledgements	Recognitiones	
activated	activate	
add	adder	
added	addite	
Adding	Adder	
additions	additiones	
advantages	avantages	
affects	affice	
Aided	assistite	
allow	permitte	
allows	permitte	
alternative	alternative	
ancillary	auxiliar	
answers	responsas	
appears	compare	
Appendix	Appendice	
applications	applicationes	
applied	applicate	
applies	refere	
approved	approbate	
Arabic	Arabe	
archives	archivos	
are	es	
arguments	argumentos	
arranged	arrangiate	
arrays	matrices	
arrows	flechas	
as a result of the	a causa del	
aspects	aspectos	
assigned	assignate	
assigning	como assignar	
Assisted	Assistite	
associated	associate	
attempt	tenta	
aunching	lancear	
automatically	automaticamente	
await	attende	
backup	copia de reserva	
Bartender	servitor	
basics	le bases	
Be warned	Presta attention	
behaviour	comportamento	
bold	nigrato	
borders	bordos	
boundaries	limites	
browse	browse	
browser	lector del tela	
browsers	lectores del tela	
bug	defecto	
Bug	cimice	
bugging	importunante	
bugs	defectos	
build	construer	
building	construer	
builds	es basate	
bundled	impacchettate	
by clicking	cliccante	
called	nominate	
calls	appellos	
can	pote	
cancelled	cancellate	
Cannot	On non pote	
capabilities	capacitates	
carefully	exactemente	
cases	casos	
CAT	CAT	
causes	causa	
change	mutar	
changed	cambiava	
changes	cambios	
Chapter	Capitulo	
chapters	capitulos	
char	character	
character	character	
characters	characteres	
characters	characteres	
chars	characteres	
Chechen	Chechen	
check box	quadrato de controlo	
checked	verificate	
checked	marcate	
checker	corrector	
checks	controlos	
chosen	selecte	
civil	civil	
class	classes	
Click	Clicca	
clicked	cliccate	
clicking	cliccar	
clicking	cliccante	
client	cliente	
clients	Clientes	
close	claude	
closes	claude	
closing	clauder	
codes	codices	
collaborative	facite in collaboration	
columns	columnas	
combination	combination	
come	venite	
commands	commandos	
commas	virgulas	
comments	commentos	
commit	commit	
compiling	compilation	
comprises	include	
Computer	computator	
computer-assisted translation	traduction adjutate ab computator	
computers	computatores	
confident	confidente	
confirm	confirmar	
consist	consiste	
consists	consiste	
console	consola	
constitute	forma	
constructed	struite	
consulted	consultate	
contain	continer	
contain	contine	
containing	continente	
contains	contine	
contents	contentos	
contributed	contribuite	
contributing	contribuer	
contributions	contributiones	
contributors	contributores	
control	controlo	
copies	copias	
copying	copiar	
corrected	correcte	
correcting	corriger	
corresponding	correspondente	
corresponds	corresponde	
corrupted	corrupte	
corrupting	corrumper	
could be	es possibile	
counterpart	pendant	
counters	contatores	
created	create	
creates	crea	
creating	creation	
creator	creator	
current	actual	
currently	actualmente	
cursor	cursor	
customization	personalisation	
customization	adaptation	
customize	accostumar	
customized	personalisate	
customizing	personalisar	
cut	seca	
damaged	damnificate	
data	datos	
deals with	tracta	
declare	proclama	
decoding	decodification	
deeper	plus profunde	
default	jam arrangiate	
defined	definite	
deliberately	deliberatemente	
delimited	delimitate	
demonstrate	demonstra	
demonstrates	demonstra	
described	describite	
described	describite	
describes	describe	
desired	desiderate	
desktop	scriptorio	
details	detalios	
detect	deteger	
detect	discoperir	
detected	detectate	
developed	disveloppa	
developers	disveloppatores	
dialog	Fenestra de dialogo del	
dialog	fenestra de dialogo	
dialogs	dialogos	
dialogs	fenestras de dialogo	
Dictionaries	Dictionarios	
differ	differer	
differentiates	distincte	
differing	differente	
directly	directemente	
Directories	plicas	
disabled	impedite	
discovered	discoperte	
discovered	discoperte	
discusses	disserta	
displayed	displicate	
displayed	exponite	
displayed	exponite	
displays	expone	
disregarding	in vice de	
Do not	Non	
document	documento	
documents	documentos	
does not	non	
does not yet	nondum	
doing	facer	
domain	dominio	
done	facite	
double-click	clicca duo vices	
dowloading	discargar	
download	discarga	
download	cargar sur disco ab internet	
download	discarga	
Download	Discargar	
downloaded	discargate	
downloaded	discargate	
downloading	discargamento	
Downloading	Discargar	
Dutch	Hollandese	
e.g.	e.g.	
e.g.	exempli gratia	
easier	plus facile	
Edit	Edita	
editable	editabile	
editable	modificabile	
Editing	Editar	
editing	editar	
Editing Behavior	Comportamento del Modifica	
editor	editor	
embarrassment	embarasso	
encoding	codification	
encodings	codificationes	
encountered	incontrate	
End	Fin	
engineering	ingenieria	
ensure	assecurar	
enter	inscribe	
entered	inscribite	
entries	entratas	
errors	errores	
Escaped	escappate	
essentially	essentialmente	
etc.	etc.	
eventually	eventualmente	
examples	exemplos	
exception	exception	
exceptions	exceptiones	
exist	existe	
exists	existe	
explain	explica	
explains	explica	
export	exportar	
Exporting	Exportar	
expressions	expressiones	
extensions	extensiones	
extensively	amplemente	
extracted	extrahite	
facilitating	assi que on facilita	
Failed	mancate	
failed	fallite	
Failed to load	Mancate carga	
failing	in defecto	
feature	characteristica	
features	characteristicas	
fields	campos	
file	file	
file	file	
File formats	Formatos del files	
Filename	nomine	
filename	nomine de file	
files	files	
Filters	filtros	
financially	financiarimente	
finding	discoperir	
finds	discopertas	
fine-tuning	accordatura fin	
finished	clause	
finished	finite	
folder	classificator	
folder	cartotheca	
folder	plica	
folders	classificatores	
folders	plicas	
folders	plicas	
follows	seque	
font	typo del character	
footer	pede de pagina	
forever	sempre	
formats	formatos	
formatted	formate	
formatted	formattate	
Formatted text	Formatted text	
Formatted text	Texto formattate	
formatting	formato	
forms	formas	
found	discoperte	
found	trovate	
free	gratuite	
French	francese	
full	complete	
functionality	functionalitate	
functions	functiones	
fuzzy	confuse	
fuzzy	partial	
fuzzy match	concordantia confuse	
Generate	Genera	
generated	generate	
getting bogged down	arenarse	
getting involved	ingagiar se	
given	date	
glossaries	glossarios	
Glossaries	Glossarios	
Go to	Vade a	
Google	Google	
Goto	Vade	
granted	accordate	
graphics	graphicos	
greater	major	
greater	major	
grouped	regruppate	
guarantees	garanti	
handle	tractar	
handled	tractate	
handling	maneamento	
handling	tractamento	
has a built-in	include	
has to be	debe esser	
have	haber	
have been	esseva	
having to	deber	
header	testa	
hears	ascolta	
heavily	pesantemente	
heavily tagged	multo gravate ab tags	
here is	ecce	
hierarchies	hierarchias	
highlighted	marcate	
highlights	aspectos notabile	
hints	consilios	
hosted	hospite	
HTML	HTML	
icons	icones	
If	Si	
ignore	ignora	
ignored	ignorate	
implementation	installation	
implementations	installationes	
implicitly	implicitemente	
import	importar	
important	importante	
importing	como importar	
impractical	impractica	
impractical	impractic	
improved	meliorate	
includes	include	
including	includente	
inconsistencies	contradictiones	
Index	Indice	
indicated	indicate	
indicating	indicante	
inflected	declinate	
info	informationes	
information	information	
initialize	initialisar	
initializing	initialisar	
inserting	insere	
inspired	inspirate	
install	installa	
install	installar	
installed	installate	
installing	installation	Installation
Installing	installar	
Instant	comenciamento	
Instant	instantanee	
instant	celere	
instead	in vice	
instructions	instructiones	
intended	designate	
interface	interfacie	
interfering	interferentia	
Internet	Interrete	
Internet	interrete	
intricacies	complicationes	
introduction	introduction	introduction
invoked	invocate	
involved	implicate	
is	es	
isn't	non es	
ISO	ISO	
issues	questiones	
Italian	italiano	
italics	italico	
items	articulos	
items	commandos	
Java	Java	
job	obra	
jobs	obras	
Kaptain	Kaptain	
keeping	tener	
kept	conservate	
keyboards	clavieros	
keys	claves	
keyword	parola clave	
Languages	Linguas	
languages	linguas	
LanguageTool	LanguageTool	
later	subsequente	
later	ulterior	
launched	lanceate	
launching	tu ha lanceate	
launching	ha ponite in marcha	
layout	arrangiamento	
Left	Sinistre	
legacy	hereditage	
Legal	legal	
lengths	longitudes	
level	nivello	
libraries	librerias	
likely	verosimilante	
link	ligamine	
link	ligar	
links	ligamines	
listed	listate	
lists	listas	
loaded	cargate	
loads	carga	
Local Disk	Disco Local	
Localizing	Localisation	
located	localisate	
located	ubicate	
locations	locationes	
login	registrar se	
looks	quere	
losing	perdita	
Mac	Mac	
machine translation	traduction a machina	
made	face	
maintained	mantenite	
maintains	gere	
makes	rende	
malformed	mal formate	
managers	administratores	
manually	manualmente	
mark	marca	
Match	concordantia	
match	concordantia	
matches	equala	
matches	concordantias	
matching	concordantia	
materials	materiales	
maximize	maximisa	
maximize	maximisar	
may	pote	
meaning	significato	
means	significa	
mediawiki	mediawiki	
members	membros	
membership	adhesion	
memories	memorias	
menu	Menu	
menus	menus	
merged	mergite	
methods	methodos	
Microsoft	Microsoft	
might	pote	
minimize	minimisar	
minimize	minimisa	
minutes	minutas	
miscellanea	miscellanea	
missing	perdite	
missing	mancante	
mistakes	errores	
moderated	moderate	
modifications	modificationes	
modified	modificate	
monitored	examinate	
moving	mover se	
must	debe	
must	debe	
My Computer	Ressources del Computer	
named	nominate	
names	nomines	
necessarily	necessarimente	
needs	necessitates	
needs	necessita	
new	nove	
newbie	neophyto	
Next	Prox	
normally	normalmente	
not	non	
notes	notas	
notices	Informationes	
null	nulle	
number	numero	
numbered	numerate	
numbering	numeration	
numbers	numeros	
object-oriented	orientate al objecto	
obtaining	obtener	
occured	occurreva	
occurred	occurreva	
occurrences	occurrentias	
of interest	interessante	
offending	indecente	
offered	offerite	
offers	offere	
offline	off-line	
OK	OK	
OmegaT	OmegaT	
OmegaT	OmegaT	
OmegaT's	de OmegaT	
omissions	omissiones	
omitted	omittite	
on-screen	su-schermo	
one	un	
online	in interrete	
open	aperir	
Open	Aperi	
open-source	open-source	
opened	aperte	
opening	pro	
opens	se displica	
opens	se displica	
operating	operative	
opt	optar	
Options	Optiones	
options	optiones	
orphan	orphane	
others	alteres	
output	output	
overlap	superponer	
overwritten	superscribite	
packaged	impaccate	
packages	pacchettos	
page	pagina	
pages	paginas	
pairs	pares	
pane	quadro	
pane	quadro	
panel	quadro	
panels	pannellos	
panes	quadros	
paragraphs	paragraphos	
parameters	parametros	
parse	analyse	
parsing	analyse	
parts	partes	
password	contrasigno	
paste	collar	
pasted	collate	
path	via	
Pattern	schema	
patterns	modellos	
patterns	patronos	
PC	PC	
perception	perception	
permissions	permissions	
phrases	phrases	
physically	physicamente	
piece	pecia	
placed	poneva	
places	locos	
plain	simple	
Plain text files	Files de texto simple	
plugin	plugin	
plugins	plugins	
points	punctos	
Polish	polaco	
portions	portiones	
positives	positivos	
possibilities	possibilitates	
power	potente	
practical	practic	
preferences	preferentias	
preferred	ideal	
prepositions	prepositiones	
presented	presentate	
pressing	pressante	
Prev	Prec	
preventing	impedir	
probably	probabilemente	
Problems	Problemas	
procedures	proceduras	
produced	producite	
programmer	programmator	
programming	programmation	
programs	programmas	
project	projecto	
Project	Projecto	
projects	projectos	
prompted	suggerite	
properties	proprietates	
Properties	Proprietates	
proposes	propone	
prototype-based	basate sur prototypo	
provided	fornite	
provided	a condition que	
provided	supplite	
provides	provide	
proxy	proxy	
purposes	fines	
put	pone	
putting	poner	
questions	questiones	
read	legite	
readership	lectores	
receive	reciper	
recognise	recognoscer	
recognizes	recognosce	
recommend	recommenda	
recorded	registrate	
recovery	recuperation	
recreate	recrear	
redistribute	redistribuer	
References	referentias	
regarding	re	
regardless	in vice de	
Regular expressions	expressiones regular	
related	pertinente	
release	edition	
releases	editiones	
relevant	pertinente	
reliable	digne de fide	
reload	recargar	
Reloads	recarga	
remaining	restante	
remember	recordar	
removes	elimina	
repetitions	repetitiones	
Replace	reimplacia	
replacing	reimplaciamento	
reported	reportate	
reports	reportos	
repository	thesauro	
repository	repository	
reproduce	representa	
reproduced	copiate	
requests	demanda	
required	requirite	
requires	necessita	
resegment	segmentar de novo	
reserves	reserva	
reset	prefixation	
reset	prefixar	
resides	reside	
resolved	resolute	
respectively	respectivemente	
response	responsa	
results	resultatos	
retained	retenite	
returned	rendite	
revising	revidite	
Right	Dextra	
rights	privilegios	
rule	regula	
rules	regulas	
run	exeque	
run	execution	
running	executar	
runtime	runtime	
save	salvar	
saved	salvate	
saves	que tu salva	
saves	salva	
scans	scande	
screams	critos	
screen	schermo	
script	scriptura	
script	script	
Scripting	Script	
Scripting dialog	Fenestra de dialogo Scripting	
scripts	scripturas	
searches	recercas	
Searching	Cerca	
see	vide	
segment	segmento	
segmenting	segmentation	
segments	segmentos	
select	selige	
selected	seligite	
Selecting	Selectionar	
self-explanatory	auto-explicative	
self-signed	firmate	
self-training	auto-exercitation	
sentence	phrase	
sentence	phrase	
serialized	convertite	Serializzazione è la conversione di un oggetto in una serie di byte, in modo che l'oggetto può essere facilmente salvato nella memoria o trasmesso attraverso un collegamento di comunicazione.
server	server	
serves	servi	
services	servicios	
session	session	
set up	preparar	
set up	preparar	
sets	locationes	
sets	collectiones	
setting	preparation	
settings	preparationes	
settings	preparationes	
setup	preparar	
setup	preparation	
Setup	Preparation	
setup	preparation	
shared	in commun	
shortcut	connexion	
shortcut	via breve	
shortcuts	vias breve	
should	deberea	
shown	monstrate	
shows	monstra	
significantly	significativemente	
similarity	similantia	
simplest	plus simple	
simplify	simplifica	
simply	simplemente	
simultaneously	simultaneemente	
single	sol	
sites	sitos	
skipped	saltate	
slightly	legiermente	
snippet	retalio	
software	software	
sorted	ordinate	
source	primari	
Source files	Files fonte	
SourceForge	SourceForge	
spaces	spatios	
spammers	disturbatores	
spared	sparniate	
specified	specificate	
specify	specificar	
specify	attribue	
spell	orthographic	
spell checker	corrector orthographic	
spell checkers	correctores orthographic	
spellchecker	corrector orthographic	
spellchecking	controlator orthographic	
spelling	orthographia	
spurious	false	
StarDict	StarDict	
Start	comenciamento	
Start	Initio	
started	initiava	
starting	in marcha	
stated	constatate	
statistic	statistic	
Steps	Passos	
stops	arresta	
storage	immagazinage	
store	registrar	
stored	registrate	
stores	registra	
stream	curso	
strengths	punctos forte	
string	linea	
structured	structurate	
styles	stilos	
sub-folders	sub plicas	
subdirectories	subcamisas	
subfolder	subcamisa	
subfolders	subcamisas	
subheads	sub titulos	
submit	submission	
such	assi como	
suit	adaptar	
summarizes	reassume	
supplied	supplite	
supported	supportate	
supporting	que supporta	
supports	supporta	
SVN	SVN	
swing thread	torno de discussion	
synchronized	synchronisate	
Systems	systemas	
Table	Tabula	
Table	Tabella	
tables	tabellas	
tag	etiquetta	
tag	tag	
tags	etiquettas	
tags	tags	
tags	etiquettas	
tags	tags	
takes	necessita	
target	final	
Target files	>Files final	
Template	exemplar	
template	modello	
term	expression	
term	expression	
terminates	termina	
terms	terminos	
text	texto	
Text Search	Cerca Texto	
texts	textos	
The	Le	
the Editing pane	le quadro pro Editar	
the Fuzzy Matches pane	le quadro pro le Concordantias Confuse	
the Fuzzy Matches pane	le quadro pro le Concordantias Partial	
the Glossary pane	le quadro pro le Glossario	
the same	identic	
them	los	
them	illos	
they	illos	
things	cosas	
those	illos	
thus	assi	
TMX	TMX	
to	pro	
To	Pro	
to	in	
to contact	continger	
to get you started	pro initiar	
to suit	adaptar	
to translate	traducer	
toggle	commutar	
tools	instrumentos	
Tools	Instrumentos	
translate	traducer	
Translate	Render	
translated	traducite	
translated	rendite	
translating	traduction	
translation memories	memorias traduction	
translation memories	memorias de traduction	
translation memory	memoria de traduction	
translations	traductiones	
translators	traductores	
triggered	discatenate	
Turkish	turco	
tutorial	parve instruction	
type	scribe	
typed	inscribe	
types	typos	
Unable	Incapace	
unbound	disligate	
unchanged	sin alteration	
underlined	sublineate	
underlying	natural	
understands	comprende	
unfinished	incomplete	
unformatted	non formattate	
uninstalling	disinstallation	
uninstalling	disinstallar	
units	unitates	
unrelated	non connexe	
unrestricted	sin restriction	
unsupported	non supportate	
untranslated	non rendite	
untranslated	non traducite	
Unzip	Expande	
up to	usque a	
update	renovation	
update	renovar	
updated	renovate	
upgrade	promover	
upgrades	renovationes	
upgrading	promotion	
uppercase	capital	
URL	URL	
Usage	Uso	
use	usar	
User	usuario	
user	usator	
user	usuario	
user	usator	
User Group	Gruppo del usatores	
user-friendly	facile	
User's	del usator	
User's Guide	Guida del usator	
User's Manual	Manual del Usator	
username	nomine del usator	
username/password	nomine del usator/contrasigno	
users	usatores	
Users	usatores de	
User's group	gruppo del usatores	
uses	usa	
using	usante	
using	usar	
usually	habitualmente	
Validate	Que tu valida	
validated	validate	
validating	validation	
variables	variabiles	
variants	variantes	
varieties	varietates	
versioning	controlo de version	
versions	versiones	
view	examinar	
View	Vista	
volunteer	voluntarie	
Volunteers	voluntarios	
vs	contra	
warnings	advertimentos	
was	esseva	
ways	manieras	
weakly	debilemente	
web	TTT	
Web browser	lector del tela	
what	lo que	
When	Quando	
which can be accessed	accessibile	
widely	largemente	
widgets	Etiquettas	
Wikipedia	Wikipedia	
wildcard	generic	
will be	essera	
will constitute	constituera	
will continue	continuara	
will need	necessitara	
will open	aperira	
will parse	analysara	
will present	proponera	
Windows	Windows	
windows	fenestras	
With	Con	
words	parolas	
workarounds	arrangiamentos	
working	functionante	
works	opera	
writeable	scribibile	
XML schemas	XML schemas	Uno XML Schema è un documento XML che utilizza un insieme di tag speciali per definire la struttura di un documento XML. Da questa definizione emerge subito una novità interessante: viene utilizzato un documento XML per validare un altro documento XML!
XML-based	basate sur XML	
yells	crita	
yields	rende	
You	Tu	
you may	tu pote	
